#编码|衣物颜色
BLS|白蓝色
BS|白色
BS-GZ|白色LV格子
BS-H|白色LV花
CS|橙色
FS|粉色
GW|格纹
HBS|花白色
HongS|红色
HS|黑色
HS=HB|黑色LV花包
HS-HW|黑色LV花纹
HuangS|黄色
HuiBS|灰白色
HuiS|灰色
KFS|咖啡色
LS|蓝色
LvS|绿色
MiB|米白
MiH|米黄
MLS|墨绿色
QLS|浅绿色
QT|其他
QZS|浅棕色
YS|银色
ZB|竹白
ZHS|棕红色
ZiS|紫色
ZL|竹绿
ZaS|杂色
ZS|棕色
ZS-GZB|棕色LV格子包
ZS-YLHB|棕色鱼鳞花包