#编码|衣物名称|默认单位
px|皮鞋|双
yrfd|羽绒服-短|件
mcf|迷彩服|件
nzk|牛仔裤|件
ry|绒衣|件
cfy|冲锋衣|件
cd|床单|件
yrfc|羽绒服-长|件
军大衣|件
py|皮衣|件
tx|T恤|件
myh|毛衣厚|件
mcft|迷彩服套|套
qy|秋衣|件
jk|夹克|件
gzf|工作服|件
zz|藏装|件
qz|裙子|条
lyq|连衣裙|件
my|毛衣|件
mck|迷彩裤|件
ndy|呢大衣|件
fy|风衣|件
xz|西装|件
mcdy|迷彩大衣|件
xk|西裤|件
cdbt|床单被套|件
yrk|羽绒裤|件
ydk|运动裤|件
